111111111111111111111111111111111111111111111
110101010100000000000000010101010101011101011
110111010111000000000000000000000000011011111
110111010111011101110111010101011101011101111
110111010111011101110111010101011101C11101111
110101010111010101110101010101010101011101011
1101010101110C0000000000000C01010101011101011
110111010111011101110111010101011101P11101111
110111010111011101110111010101011101011101111
1101110101110111E1110111010101011101011101111
110101010111010101110101C10101010101011101011
110101000000000101110101010101010101111010111
110111010111011101110111010101011101011101111
111111111111111111111111111111111111111111111