11111111111111111111
10C01111111111111111
1000000000000000P001
1000101110C00C001111
10111000000000000001
10111111111111111111
10000C000000C0000011
1E111010111111110101
11111111111111111111